_ _ b b b b _ _
_ _ s s s s _ _
_ _ b b b b _ _
_ _ b b b b _ _
_ _ u u u u _ _
